
##########
#X# ##0 ##
# #  ##  #
# ## ##  #
#    ### #
#### ### #
#    ### #
# ###### #
#        #
##########
